25
1 1 1 1 1 1 1 1 1 1 1 1 1 1 1 1 1 1 1 1 1 1 1 1 1
1 4 4 4 4 4 0 0 0 2 0 0 0 0 0 0 1 0 0 0 5 0 0 0 1
1 4 0 0 0 4 0 1 0 2 2 0 2 2 2 0 1 0 0 0 0 0 0 0 1
1 4 0 0 0 0 0 0 0 2 2 0 2 2 0 0 1 1 0 1 0 1 0 1 1
1 4 0 4 4 4 0 0 0 2 0 0 0 3 0 3 3 3 0 0 0 0 0 2 1
1 2 0 2 2 2 0 0 0 2 0 0 0 3 0 3 3 3 0 0 0 0 0 2 1
1 0 0 0 0 0 0 0 0 0 0 0 0 2 0 2 2 2 2 0 2 2 2 2 1
1 0 0 0 0 0 0 0 0 0 0 0 0 0 0 0 0 0 0 0 0 0 0 2 1
1 1 1 1 1 1 0 0 0 1 0 0 0 4 4 4 5 0 0 0 0 0 0 2 1
1 5 0 4 0 0 0 0 0 0 0 0 0 0 0 0 4 2 2 2 2 0 2 2 1
1 5 0 0 0 0 0 0 0 0 0 0 0 4 4 0 4 4 4 3 0 0 0 0 1
1 5 0 0 0 0 0 0 0 1 0 0 0 0 0 0 0 0 0 4 0 0 0 0 1
1 4 0 0 0 0 0 0 0 0 0 0 0 0 3 0 3 0 3 3 3 0 0 0 1
1 0 0 0 0 0 0 0 0 0 0 0 0 0 0 0 0 0 0 4 0 0 0 0 1
1 0 0 0 0 0 1 0 0 1 3 3 3 0 3 0 3 0 3 3 3 0 0 0 1
1 0 0 0 0 0 3 0 0 0 0 0 3 0 3 3 3 3 3 0 0 0 1 0 1
1 0 0 0 0 0 3 0 0 0 0 0 3 1 1 1 1 1 1 1 1 1 1 0 1
1 0 0 2 2 0 3 3 3 1 0 0 3 1 0 0 0 0 0 0 1 0 0 0 1
1 0 0 2 2 0 0 0 0 0 0 0 0 1 0 0 0 0 0 0 1 0 1 1 1
1 0 0 0 0 0 0 0 0 0 0 6 0 3 0 3 3 3 3 3 2 0 2 0 1
1 0 0 4 4 0 0 3 3 0 0 0 0 0 0 0 0 0 0 3 3 0 3 0 1
1 6 0 4 4 0 0 3 3 6 0 0 1 2 2 2 0 0 0 4 4 0 4 0 1
1 6 0 0 6 5 0 0 0 6 0 0 0 0 2 2 0 0 0 0 0 0 0 0 1
1 6 6 0 0 0 0 0 0 0 0 0 1 2 2 2 0 0 0 4 4 5 5 4 1
1 1 1 1 1 1 1 1 1 1 1 1 1 1 1 1 1 1 1 1 1 1 1 1 1
