17
17
1 1 1 1 1 1 1 1 1 1 1 1 1 1 1 1 1 1
1 1 1 2 2 1 1 1 1 1 1 1 1 1 1 1 1 1
1 2 0 0 2 0 0 0 1 0 0 0 0 1 0 0 2 1
1 1 0 0 0 0 4 0 0 0 6 6 0 1 0 0 2 1
1 1 0 0 5 6 6 6 6 5 6 0 0 1 0 4 1 1
1 1 0 0 6 0 0 7 7 6 0 0 0 0 0 0 2 1
1 1 0 0 6 0 0 0 8 6 0 1 0 5 5 0 1 1
1 1 0 0 6 0 0 7 7 6 0 1 0 5 0 0 1 1
1 2 0 0 5 4 0 4 5 5 0 5 0 1 0 1 1 1
1 2 2 0 0 0 0 0 0 4 0 9 0 0 0 0 1 1
1 2 2 0 5 0 1 1 0 1 0 9 0 9 9 9 7 1
1 2 0 0 0 0 0 7 0 2 0 0 0 0 0 0 7 1
1 1 0 1 0 5 0 7 0 0 0 6 6 0 0 0 7 1
1 1 0 1 0 0 0 3 0 3 0 0 0 6 0 7 3 1
1 2 0 5 5 5 0 7 0 0 0 4 0 6 6 5 2 1
1 2 0 0 0 0 0 7 0 0 0 4 0 0 0 0 2 1
1 1 1 1 1 1 1 3 3 2 1 1 1 1 1 1 1 1
1 1 1 1 1 1 1 1 1 1 1 1 1 1 1 1 1 1
